R 1200 800
SO ./pictures/text2.xpm
WE ./pictures/text3.xpm
S ./pictures/portal.xpm
EA ./pictures/text4.xpm
NO ./pictures/text1.xpm
F 0,0,0
C 0,0,0 
11111111111111111111111111111111111111111111111111
10000000000000000001111111111111111111100000001111
11111111111111111000000000001111111111011111101111
11111111111111111111111100001111111111011111101111
11111111111111111111111110011111111111011111101111
11111111111111111111111110000000000000001111101111
11111111111111111111111120011111111111111111101111
11111111111111111000000000111111111111111111101111
11111111111111111000111111111111111111111111101111
11111111100000000000000000000000000000000111101111
11111111000001111111111111111111111101111111101111
11111111110011111111111111111111111100000000000011
11111111111011111111111000000000000001111111101111
11111111110111110000000000011111111111111111101111
11111111101111111000000011111111111111111111101111
11111000111110000000111111111111111111111111101111
11111001111111001111111111111111111111111111101111
11111001111111001111111111111111111111111111101111
11111100000000011111111111111111111111111111101111
11111111111110111111111111111111111111111111101111
11111111111110111111111111111111111111111111101111
11111111111110000000000000000000000000000000001111
11111111111110111111111111111111111111111111111111
11111111111110111111111111111111111111111111111111
10000000000000100000100000010000000000000000000001
10020000000000000002000000000000000000000002000001
100200000000000000000000000000000020000000000000E1
10020000000000000000200000000000000000000000001001
10000000000000000000000000001000000000000000002001
11111111111111111111111111111111111111111111111111
