R 1200 800
SO ./pictures/lava.xpm
WE ./pictures/diamond.xpm
S ./pictures/portal.xpm
EA ./pictures/stone.xpm
NO ./pictures/wood.xpm
F 0,100,30
C 50,0,170 
1111111111111111111111111111111111111111111111111
10000000000000000001111111111111111111100000000E1
1111111111111111100000000000111111111101111110111
1111111111111111111111110000111111111101111110111
1111111111111111111111111001111111111101111110111
1111111111111111111111111000000000000000111110111
1111111111111111111111112001111111111111111110111
1111111111111111100000000011111111111111111110111
1111111111111111100011111111111111111111111110111
1111111110000000000000000000000000000000011110111
1111111100000111111111111111111111110111111110111
1111111111001111111111111111111111110000000000021
1111111111101111111111100000000000000111111110111
1111111111011111000000000001111111111111111110111
1111111110111111100000001111111111111111111110111
1111100011111000000011111111111111111111111110111
1111100111111100111111111111111111111111111110111
1111100111111100111111111111111111111111111110111
1111110000000001111111111111111111111111111110111
1111111111111011111111111111111111111111111110111
1111111111111011111111111111111111111111111110111
1111111111111000000000000000000000000000000000111
1111111111111011111111111111111111111111111111111
1111111111111011111111111111111111111111111111111
1000000000000010000010000001000000000000000000001
1002000000000000000200000000000000000000000200001
1002000000000000000000000000000000200000000000001
1002000000000000000020000000000000000000000001001
1000000000000000000000000000100000000000000002001
1111111111111111111111111111111111111111111111111
