R 1000 500
NO ./path_to_the_north_texture
SO ./path_to_the_south_texture
WE ./path_to_the_west_texture
EA ./path_to_the_east_texture
S ./path_to_the_sprite_texture
F 131, 0, 39 
C 46, 82, 111
11111111111111111111111111111111111111111111111111
10000000000000000002222222222222222222200000002221
12222222222222222000000000002222222222022222202221
12222222222222222222222200002222222222022222202221
12222222222222222222222220022222222222022222202221
12222222222222222222222220000000000000002222202221
12222222222222222222222200022222222222222222202221
12222222222222222000000000222222222222222222202221
12222222222222222000222222222222222222222222202221
12222222200000000000000000000000000000000222202221
12222222000002222222222222222222222202222222202221
12222222220022222222222222222222222200002222202221
12222222222022222222222000000000000002222222202221
12222222220222220000000000022222222222222222202221
12222222202222222000000022222222222222222222202221
12222000222220000000222222222222222222222222202221
12222002222222002222222222222222222222222222202221
12222002222222002222222222222222222222222222202221
12222200000000022222222222222222222222222222202221
12222222222220222222222222222222222222222222202221
12222222222220222222222222222222222222222222202221
12222222222220000000000000000000000000000000002221
12222222222220222222222222222222222222222222222221
12222222222220222222222222222222222222222222222221
10000000000000000000000200000000000000000000000001
10000000000000000000000000000000000000000000000001
10000000000000000002000E00020000000000000000000001
10000000000000000000000000000000000000000000000001
10000000000000000000000200000000000000000000000001
11111111111111111111111111111111111111111111111111
