R 1200 800
NO ./tsawer/lava.xpm
SO ./tsawer/diamond.xpm
WE ./tsawer/wood.xpm
EA ./tsawer/stone.xpm
S ./path_to_the_sprite_texture
F 131, 0, 39 
C 46, 81, 111
11111111111111111111111111111111111111111111111111
10000000000000000001111111111111111111100000001111
11111111111111111000000000001111111111011111101111
11111111111111111111111100001111111111011111101111
11111111111111111111111110011111111111011111101111
11111111111111111111111110000000000000001111101111
11111111111111111111111100011111111111111111101111
11111111111111111000000000111111111111111111101111
11111111111111111000111111111111111111111111101111
11111111100000000000000000000000000000000111101111
11111111000001111111111111111111111101111111101111
11111111110011111111111111111111111100001111101111
11111111111011111111111000000000000001111111101111
11111111110111110000000000011111111111111111101111
11111111101111111000000011111111111111111111101111
11111000111110000000111111111111111111111111101111
11111001111111001111111111111111111111111111101111
11111001111111001111111111111111111111111111101111
11111100000000011111111111111111111111111111101111
11111111111110111111111111111111111111111111101111
11111111111110111111111111111111111111111111101111
11111111111110000000000000000000000000000000001111
11111111111110111111111111111111111111111111111111
11111111111110111111111111111111111111111111111111
10000000000000000000000000000000000000000000000001
10000000000000200000010110000000000000000000000001
100000000E0000200000010110000000000000000000000001
10000000000000200000010010000000000000000000000001
10000000000000000000011110000000000000000000000001
11111111111111111111111111111111111111111111111111
